# Non-IGL Players and Their Team Rosters

## A

- Abo (Titan Esports Club) – Teammates: Haodong, dynamite, CoCo, TvirusLuke, lucas
- ACHRF (Levant & North Africa team) – Teammates: Kaqnn, Kheops, Wily, zMART
- AcMe (DSYRE) – Teammates: Jomba, Keiko, Moon, L0udly
- Addicted (SAW) – Teammates: brk, Fragger, Cunha20, GrTw
- Adenina (FENNEL) – Teammates: Minty, Corey, Allen (JP), Rinne
- Adverso (KRÜ Esports) – Teammates: Keznit, Melser, NagZ, xand
- Akira (REJECT) – Teammates: Barce, TakeJ, JoXJo, Zen
- AL7B (Team Falcons) – Teammates: Mashael, Kuroro, MSOL, xPo
- Alessia (GX3) – Teammates: annie, Risie, Carolina, di^
- Allen (BC SWELL) – Teammates: sakura, Jan, Jerry, JinbeyS
- Amaterasu (Team Sarafa) – Teammates: Antidote, MW1, Xhade, Whimp
- Andrehs (Havan Liberty) – Teammates: Shion, Myssen, krain, pleets
- AndreSG (Revenge Gaming) – Teammates: Nyx, p1, Ryx, Shu
- ANGE1 (NAVI) – Teammates: cNed, Shao, Zyppan, SUYGETSU
- Antidote (Team Sarafa) – Teammates: Amaterasu, MW1, Xhade, Whimp
- APHUN (Bleed Esports) – Teammates: Maxie, rSt, Retla, Nephh
- Arch (Mindfreak) – Teammates: pzK, Reeps, Motion, Bob
- Art (Team Heretics) – Teammates: Mixwell, lowel, niesoW, pAura
- Artzin (Fenerbahçe Esports) – Teammates: Elite, Toronto, qRaxs, muj
- AYRIN (Global Esports) – Teammates: SkRossi, Lightningfast, Texture, Bazzi

## B

- B3Ar (KONE eSports) – Teammates: ShadoW, Ambi, H1ber, Doma
- B3ASTM0D3 (GnG Amazigh) – Teammates: Takahara, Shalaby, MSB, Ryu
- Bati (FUT Esports) – Teammates: MOJJ, qRaxs, Muj, sterben
- Bazz (Crest Gaming Zst) – Teammates: Alpha, Ruki, sakurai, Brofeld
- BEAST (Orangutan) – Teammates: Tesseract, Vibhorr, Persia, Azys
- Benzki (Falcons Vega) – Teammates: Shalaby, Cyph, mslm, ZiN
- BerLIN (CGN Esports) – Teammates: g0ofy, prr, Levi, LyGHT
- Biank (Fire Flux) – Teammates: SasuKe, Elite, Toronto, Masic
- Bishepss (Waveless) – Teammates: ShadooW, Ec1s, kAdavra, Sherriff
- BlitzeN (SCARZ) – Teammates: Baz, Dep, SugarZ3ro, Crow
- Blossi (NORTHEPTION) – Teammates: xnfri, JoXJo, Derius, BlackWiz
- Boaster (Fnatic) – Teammates: Alfajer, Chronicle, kamyk, Crashies
- Boo (Giants Gaming) – Teammates: Fit1nho, hoody, Cloud, Nukkye
- Boostio (Evil Geniuses) – Teammates: Ethan, jawgemo, Reformed, C0M
- BRIAN (REJECT) – Teammates: muto, BNN, Lamia, Reita
- Brädi (Team Vitality) – Teammates: M4CHINA, ceNder, BONECOLD, ShadoW
- BULD (FunPlus Phoenix) – Teammates: Shao, Ardiis, zyppan, SUYGETSU
- Bullet (99 Strength) – Teammates: eMIL, cosmee, ShadoW, LATEKS
- Bunni (CLG Red) – Teammates: Benita, bungee, rise, milk
- Bzt (CASE Esports) – Teammates: kusiah, lyaN, wastedd, linepro

## C

- Cavern (SR Nacague) – Teammates: berLIN, inAst, Crimson, Lawliet
- CaydeN (Leviatán) – Teammates: kiNgg, Mazino, Shyy, Tacolilla
- CeNder (Team Vitality) – Teammates: BONECOLD, Destrian, Twisten, ShadoW
- Chrollo (BOOM Esports) – Teammates: BlazeKing, fl1pzjder, famouz, Nephh
- Cille (TENSTAR Nova) – Teammates: Minnie, Ritha, Rae, Nelo
- Cloud (NAVI) – Teammates: Zyppan, Shao, SUYGETSU, ANGE1
- Cloudy (On Sla2ers KR) – Teammates: TS, Suggest, Byeon7, Erik
- CLZ (BIG) – Teammates: Gob b, k1to, DeniMM, QutionerX
- Crazyguy (Team Big BAAM) – Teammates: d0rf, Crows, FrostyZ
- Crws (XERXIA Esports) – Teammates: sushiboy, Foxz, sScary, JitboyS

## D

- Daiki (Team Liquid Brazil) – Teammates: bstrdd, nat1, drn, Joojina
- Daniel0 (Random5 Esports) – Teammates: ShadowQ, Critycal, Derker, Zyx
- Dark3st (Wild Panthers Esports) – Teammates: emrko, Kanpeki, Salt, Micka
- Deigara (Skull Cracker) – Teammates: Firenz, Vertigo, Cyanide, Soren
- Demiurge (Invictus International) – Teammates: R3tro, SLoW, falfalfal, yak

## E

- Ease (Team Queso) – Teammates: Vares, Emas, Owen, LordDemon
- Ec1s (TENSTAR) – Teammates: russ, stanley, polvi, czm
- EduCoz (ODDIK) – Teammates: fra, xand, Dragonite, Pleets
- Effy (Version1) – Teammates: vanity, penny, Zellsis, wippie
- Electus (Falling Esports) – Teammates: yCee, MrYuno, Fragile, pwyc

## F

- F0rsakeN (Paper Rex) – Teammates: mindfreak, d4v41, something, Jinggg
- Faceroll (Rise Nation) – Teammates: Derrek, Shanks, supamen, POISED
- Falltw (Invictus Gaming) – Teammates: Moji, RTFX, Dev, zzz
- Fiziq (Rebels Gaming) – Teammates: asLan, kreaz, janny, Rizz
- Flex1n (DRG) – Teammates: Nicc, TvirusLuke, SpiritZ1, vo0kashu

## G

- Gaabxx (LOUD GC) – Teammates: drn, Joojina, nat1, Daiki
- GatsH (CYCLOPS athlete gaming) – Teammates: BlackWiz, Reita, Barce, neth
- Gio (Team Finest) – Teammates: roxi, Yav1n, Feqew, taww
- Gloomy (Oasis Gaming) – Teammates: Rabbet, Invy, 2ge, eyy
- Glovee (FunCrew) – Teammates: Recon, Hani, hsaN, Senex

## H

- Hastack (Jadeite) – Teammates: dOpai, Sexycake, LeeLoo, Uebi
- Healing (SCARZ) – Teammates: Crow, Dep, makiba, Tenta
- Hiroronn (Murash Gaming) – Teammates: Kuon, Odake, Aster, Quta
- Hitch (KPI Gaming) – Teammates: ginji, Ex0, Mixwell, Filu
- Howlsv (Team Eagles) – Teammates: kensh, zyko, urashi, LUPO

## I

- ICami (GZ Esports) – Teammates: Kalla, Piu, Zero, J4CKY
- ICEKING (Team Unique) – Teammates: KLMN, ZeroGravity, Sharkz, drop
- Iluri (HC Chengdu) – Teammates: K1ra, monk, Haodong, CHICHOO

## J

- Jademwah (Rebellion GC) – Teammates: Rizky, Nirwana, Lesc, Rainboo
- Jamppi (Team Liquid) – Teammates: nAts, soulcas, Enzo, Sayf
- Jazzy (VersionX) – Teammates: florescent, milk, sarah, lilly
- Jduh (SoaR) – Teammates: LeviathanAG, Stealthy, peep, chuchu
- Jeyj7y (Random Gaming) – Teammates: MrKaaz, LunatiK, Zhoor, pxd

## K

- K0rupt (Andbox) – Teammates: Android, yay, Reduxx, Vice
- Kakarot (LFO) – Teammates: Kismet, Doombros, Riz, Platy
- KellyS (Global Esports) – Teammates: SkRossi, Lightningfast, Tesseract, Vibhorr
- Kenobi (ExceL Esports) – Teammates: AlekS, ChiLi, Moe40, Bird
- KenzmPs (INTZ) – Teammates: fra, Delevingne, mwzera, gabx

## L

- Laz (ZETA DIVISION) – Teammates: Dep, SugarZ3ro, TENNN, Crow
- LBY (Ahq eSports Club) – Teammates: kevinChou, HnG, nine, csl
- Lear (SoaR) – Teammates: Jduh, Stealthy, peep, chuchu
- Lenne (FAV gaming) – Teammates: Minty, Rinne, Allen, makiba
- Leonzhett (INFINITY) – Teammates: Cypher, Darko, Katan, Royko

## M

- M1tez (BBL Esports) – Teammates: Brave, AsLanM4shadoW, Turko, QutionerX
- M4xikk (Giants Gaming) – Teammates: hoody, Fit1nho, Cloud, nukkye
- Madv (OnlyFins) – Teammates: Peep, Muffin, Shady, Realist
- Magneto (ThunderTalk) – Teammates: HuanYu, Tiger, Vera, Sloo
- Magnum (Fnatic) – Teammates: Boaster, Derke, Doma, Mistic

## N

- Nahsie (Tenstar) – Teammates: Ec1s, Polvi, Killu, Banana
- NAts (Team Liquid) – Teammates: Jamppi, Redgar, Enzo, Sayf
- NaturE (Evil Geniuses) – Teammates: jawgemo, Derrek, icy, Supamen
- Navarro (Vivo Keyd) – Teammates: murizzz, krain, Jhow, bld

## O

- O0o0o (Nova Esports) – Teammates: SWERL, CB, GuanG, Ezeir
- Ooriime (RevolutionX) – Teammates: Yeti, Xari, Kade, Zorba
- OuTLaW (DSYRE) – Teammates: Moon, AcMe, L0udly, Jomba

## P

- PAura (Team Heretics) – Teammates: Mixwell, lowel, niesoW, Art
- Pdr (Panthers Esports) – Teammates: RzK, Plex, P4f, Luis
- Peloncito (Leviatán Academy) – Teammates: Raziel, Ntry, Ragh, Nitz

## Q

- Qpert (Soniqs) – Teammates: Dcop, Crunchy, TcF, bjor
- QqGOD (Trace Esports) – Teammates: kai, LuoK1ng, Biank, heybay

## R

- Raafa (FURIA) – Teammates: mwzera, havoc, Khalil, heat
- Rainy (Legacy Gaming) – Teammates: Maki, Neo, Fayde, Ronin
- Rb (DRX) – Teammates: stax, Zest, MaKo, BuZz

## S

- Saadhak (LOUD) – Teammates: aspas, Less, cauanzin, pANcada
- Sayf (Vitality) – Teammates: Destrian, Twisten, MOLSI, ceNder
- SEIDER (Team Vitality) – Teammates: Brams, ShadoW, ceNder, MARCTYLINHO
- Stax (T1/DRX) – Teammates: MaKo, BuZz, Zest, Foxy9
- Suzu (Reignite) – Teammates: Medusa, takej, Npoint, BlackWiz

## T

- Tarathiel (Team Refuse) – Teammates: shalaby, ksii, whipz, BuZzY
- TS (On Sla2ers) – Teammates: Suggest, Cloudy, Byeon7, TenTen
- TZX (Team Clarity) – Teammates: mistic, Enzo, Joynt, FrostX

## U

- UNFAKE (Rare Atom) – Teammates: Life, yosemite, autumn, BerLIN

## V

- Valyn (G2 Esports) – Teammates: trent, JonahP, leaf, jawgemo
- Vanity (Version1/C9) – Teammates: penny, Zellsis, effys, leaf

## W

- Woddy (World Game Star) – Teammates: Harry, Esperanza, 10X, SSeS

## X

- Xavi8k (BLEED) – Teammates: Maxie, Nephh, Retla, Juicy

## Y

- Yoman (Gen.G) – Teammates: Munchkin, t3xture, Karon, foxy9

## Z

- Zap (2Game Esports) – Teammates: pryze, lz, silentzz, gobera
- Zeddy (CGN Esports) – Teammates: g0ofy, Lyght, Levi, peet